
SO ./textures/s                
EA ./textures/r
WE ./textures/w      
NO ./textures/n  


F 153,76,255
C 26,150 ,233
    

                                       
       11111111111111111111111111111
11111111111111111111111111111111  
11111111111110100111000000000001
1000000000110N00001110111111111111
111101111111110111000000100011
111101111111110111010100100011
11000000110101011100000010001
10000000000000001100000010001
10000000000000001101010010011
11000001110101111111011110111                
1 1110111 10101 1011110100001 
11111111111111111111111111111